news	news
cbs	cbs
media	broadcast
reports	reporter
broadcast	media
coverage	reports
network	television
television	abc
newspapers	nbc
abc	newspaper
newspaper	tv
bad	network
nbc	yesterday
press	newspapers
latest	coverage
reporter	channel
conference	report
tv	magazine
magazine	reporters
reported	interview
reporters	weekly
cable	fox
evening	evening
week	cnn
radio	cable
