news	news
press	media
newspaper	broadcast
conference	conference
reports	cbs
newspapers	reports
reporters	newspaper
latest	television
interview	press
announcement	network
editorial	reporters
daily	daily
correspondent	newspapers
magazine	reporter
radio	story
report	reported
reporter	report
published	magazine
stories	interview
nbc	tv
article	evening
papers	article
message	radio
statement	bad
publicity	correspondent
