news	news
reports	press
press	newspapers
newspapers	newspaper
daily	daily
newspaper	correspondent
correspondent	story
radio	london
moscow	reports
broadcast	conference
london	editorial
editor	reporter
papers	report
reporter	radio
editorial	reporters
magazine	published
information	weekly
story	stories
latest	broadcast
published	reported
berlin	magazine
reporters	week
mail	editor
readers	comment
dispatch	interview
