news	news
message	newspapers
telegram	papers
reports	reports
brought	daily
papers	press
received	printed
press	editorial
arrival	published
report	journal
tonight	information
information	week
london	telegram
letter	editor
daily	announcement
announced	newspaper
dispatches	correspondent
newspapers	following
bad	story
today	comment
arrived	latest
morning	london
latest	hearst
sent	magazine
yesterday	publicity
