news	news
newspapers	newspapers
papers	latest
reports	reports
daily	daily
press	newspaper
printed	press
editorial	papers
published	names
journal	week
information	published
week	reporters
telegram	information
editor	announcement
announcement	headlines
newspaper	comment
correspondent	dispatches
following	weekly
story	editor
comment	london
latest	received
london	story
hearst	letters
magazine	herald
publicity	arrival
