news	news
arrival	message
telegram	telegram
unexpected	reports
departure	brought
information	papers
message	received
brought	press
papers	arrival
telling	report
received	tonight
report	information
discovery	london
concerning	letter
arrived	daily
happened	announced
luck	dispatches
latest	newspapers
coming	bad
morning	today
shortly	arrived
interview	morning
story	latest
visit	sent
reports	yesterday
