news	news
newspapers	reports
latest	press
reports	newspapers
daily	daily
newspaper	newspaper
press	correspondent
papers	radio
names	moscow
week	broadcast
published	london
reporters	editor
information	papers
announcement	reporter
headlines	editorial
comment	magazine
dispatches	information
weekly	story
editor	latest
london	published
received	berlin
story	reporters
letters	mail
herald	readers
arrival	dispatch
