news	news
media	cbs
broadcast	media
conference	reports
cbs	broadcast
reports	coverage
newspaper	network
television	television
press	newspapers
network	abc
reporters	newspaper
daily	bad
newspapers	nbc
reporter	press
story	latest
reported	reporter
report	conference
magazine	tv
interview	magazine
tv	reported
evening	reporters
article	cable
radio	evening
bad	week
correspondent	radio
