news	news
press	press
newspapers	newspaper
newspaper	conference
daily	reports
correspondent	newspapers
story	reporters
london	latest
reports	interview
conference	announcement
editorial	editorial
reporter	daily
report	correspondent
radio	magazine
reporters	radio
published	report
weekly	reporter
stories	published
broadcast	stories
reported	nbc
magazine	article
week	papers
editor	message
comment	statement
interview	publicity
