politics	politics
religion	political
political	religion
democratic	democratic
liberal	philosophy
philosophy	culture
culture	religious
economics	democracy
conservative	economics
tradition	liberal
modern	influence
literature	cultural
cultural	revolution
democracy	intellectual
science	islamic
leadership	debate
religious	institutions
contemporary	leadership
history	conservative
debate	presidential
intellectual	islam
radical	mainstream
issues	literature
views	identity
academic	relations
