politics	politics
political	political
religion	religion
affairs	economics
literature	liberal
philosophy	affairs
radical	philosophy
economic	democracy
religious	internal
democracy	interested
liberal	influence
history	international
business	tradition
practical	democratic
propaganda	revolution
reform	religious
social	policies
economics	league
policies	domestic
psychology	conservative
active	leadership
partisan	arts
sentiment	science
revolutionary	policy
communist	communism
