politics	politics
political	religion
philosophy	political
religion	democratic
history	liberal
liberal	philosophy
culture	culture
radical	economics
democratic	conservative
democracy	tradition
literature	modern
society	literature
criticism	cultural
politicians	democracy
issues	science
affairs	leadership
partisan	religious
conservative	contemporary
revolutionary	history
tradition	debate
era	intellectual
parties	radical
art	issues
contemporary	views
economics	academic
