politics	politics
political	political
religion	philosophy
philosophy	religion
democracy	history
liberal	liberal
tradition	culture
history	radical
conservative	democratic
conflict	democracy
society	literature
social	society
role	criticism
economic	politicians
science	issues
affairs	affairs
popular	partisan
influence	conservative
bourgeois	revolutionary
radical	tradition
leadership	era
religious	parties
politicians	art
issues	contemporary
communism	economics
