politics	politics
political	political
religion	religion
economics	affairs
liberal	philosophy
affairs	science
philosophy	history
democracy	business
internal	economics
interested	literature
influence	politicians
international	religious
tradition	matters
democratic	moral
revolution	democracy
religious	liberal
policies	policy
league	criticism
domestic	influence
conservative	social
leadership	democratic
arts	intellectual
science	issues
policy	interested
communism	communism
