politics	politics
political	religion
religion	political
affairs	progressive
democratic	affairs
science	politicians
national	propaganda
philosophy	radical
leaders	democracy
social	liberal
literature	reform
practical	democratic
organization	matters
administration	institutions
business	science
liberal	philosophy
international	national
matters	organization
parties	religious
interests	business
religious	literature
policy	conduct
modern	conservative
republican	republican
history	practical
