politics	politics
religion	political
political	religion
progressive	affairs
affairs	literature
politicians	philosophy
propaganda	radical
radical	economic
democracy	religious
liberal	democracy
reform	liberal
democratic	history
matters	business
institutions	practical
science	propaganda
philosophy	reform
national	social
organization	economics
religious	policies
business	psychology
literature	active
conduct	partisan
conservative	sentiment
republican	revolutionary
practical	communist
