press	press
newspaper	conference
newspapers	associated
berlin	newspaper
associated	news
official	moscow
news	reporters
speech	official
conference	speech
nazi	newspapers
moscow	agent
london	london
catholic	conferences
correspondents	spokesman
daily	correspondent
reporters	radio
washington	reports
editorial	statement
propaganda	washington
ambassador	chicago
reports	address
diplomatic	broadcast
soviet	dispatch
geneva	reported
british	disclosed
