press	press
newspapers	newspaper
associated	newspapers
reports	berlin
daily	associated
newspaper	official
printed	news
official	speech
published	conference
moscow	nazi
today	moscow
news	london
publicity	catholic
editorial	correspondents
london	daily
soviet	reporters
dispatches	washington
statement	editorial
correspondent	propaganda
gazette	ambassador
papers	reports
editor	diplomatic
report	soviet
tribune	geneva
issued	british
