press	press
conference	conference
news	reporters
reporters	media
salinger	news
speech	speech
conferences	interview
washington	ziegler
secretary	briefing
associated	statement
issued	aide
newspaper	broadcast
interview	agnew
international	secretary
moscow	reports
reporter	official
president	nixon
reports	newspaper
statement	president
presidential	newsmen
official	ronald
representatives	representatives
johnson	pentagon
pierre	aides
announcement	conferences
