press	press
newspapers	newspapers
reports	editor
official	published
report	university
dispatches	newspaper
associated	associated
newspaper	reports
printed	british
published	cambridge
german	daily
copyright	official
american	printed
london	public
authorities	magazine
editor	american
correspondent	publication
university	agent
publication	current
president	washington
association	representatives
washington	authorities
chicago	volume
public	monthly
officials	republic
