press	press
conference	conference
reporters	media
washington	reporter
media	washington
coverage	reporters
news	news
newspaper	associated
newspapers	laura
speech	detroit
briefing	dan
moscow	university
meetings	newspaper
university	release
reports	post
embassy	coverage
reporter	weekly
magazine	editors
pentagon	journal
criticism	presidential
official	magazine
corps	president
summit	ap
international	newspapers
correspondent	review
