press	press
conference	conference
news	news
speech	reporters
reporters	salinger
associated	speech
hagerty	conferences
newspapers	washington
secretary	secretary
reports	associated
broadcast	issued
newspaper	newspaper
moscow	interview
eisenhower	international
acheson	moscow
conferences	reporter
correspondent	president
reported	reports
washington	statement
dulles	presidential
weekly	official
statement	representatives
president	johnson
presidential	pierre
report	announcement
