press	press
newspapers	newspapers
editor	associated
published	reports
university	daily
newspaper	newspaper
associated	printed
reports	official
british	published
cambridge	moscow
daily	today
official	news
printed	publicity
public	editorial
magazine	london
american	soviet
publication	dispatches
agent	statement
current	correspondent
washington	gazette
representatives	papers
authorities	editor
volume	report
monthly	tribune
republic	issued
