press	press
conference	conference
reporters	reporters
media	washington
news	media
speech	coverage
interview	news
ziegler	newspaper
briefing	newspapers
statement	speech
aide	briefing
broadcast	moscow
agnew	meetings
secretary	university
reports	reports
official	embassy
nixon	reporter
newspaper	magazine
president	pentagon
newsmen	criticism
ronald	official
representatives	corps
pentagon	summit
aides	international
conferences	correspondent
