news	news
dimondstein	beglov
raymar	novosti
conference	spartak
bookazine	cyr:blau
and4	conference
mcclurg	strangep96consumer
pre-announced	scanlon'splayboydr
tansonnhut	agency
hour-iong	cbs
daily	%vitt
live-tv	cronkile
brothertheglorious	v.p.
become-as	othy
newspapers-no	buy-linesthe
hatcher.	wpix-tv
media-television	dwire
dollar-minded	daily
fogli	mcdonough
d'avvisi	two-paragraph
unern	n.b.c.
least-a	knockoff
wash-	anchorman
ten-page	c.b.s
honeybee	hairsplitter
