news	news
1,738,667	daily
nouncers.	hearst-m-g-m
rancholt	agency
ashopkins	16-foreign
3,233,407	w.g
warsden	warner-pathe
up-through-the-ranks	mato
daily	movietone
yop.k	tanjug
|p169'why	with-gossip
ha'anoichi.	a.11
agency	yugoslay
touchoff	didn'cha
dempo	newspaper
hearstian	backfence
p245disquieting	post-home
greeters	badgecumbe
patterson.	clofine
ad-journed	horse-race
prqpaganda	answers-to-queries
muoh	fotographer
havas	research-one
dispatches	serv-r
dispatch	syndicate-a
