news	news
beglov	ezechiel
novosti	ntwk
spartak	abc
cyr:blau	people-and
conference	events-wind
strangep96consumer	vacationtime
scanlon'splayboydr	cbs
agency	cnn
cbs	poll
%vitt	urged.
cronkile	iji
v.p.	newfangledstuff
othy	man-on-
buy-linesthe	broadcast
wpix-tv	bad
dwire	swifty
daily	vremya
mcdonough	anastos
two-paragraph	nightly
n.b.c.	commercialson
knockoff	conference
anchorman	#3this
c.b.s	anchorman
hairsplitter	wnew
