news	news
lomakin	oldstyle
soldier-husband	red-white-and-blue
fromajapan	a-laughin
bacht	hec
mecklenburgers	mccann
tep	chilteali-thierry
long-absent	world-hunger
offinse	upsidedown
tepe	nere
yamagata	alabtunas
the-raleigh	clearface
ornymintal	gatherer
anti-negro	music-maker
balk.	st.-mihiel
roald	146.
charleston	censorships
ranter	somwhat
anexcellent	cheltenham
pipe-players	newport
pre126	scatterer
denghil	hard-heartedness
licaly	ayenue
rammings	iscapal
l6	=like
