news	news
oldstyle	daily
red-white-and-blue	1,416,000
a-laughin	debarking
hec	dailies-
mccann	toasting-hot
chilteali-thierry	organ
world-hunger	1,226,000
upsidedown	teatime
nere	priest-editor
alabtunas	wmaq
clearface	serrati
gatherer	sheetlet
music-maker	kiel
st.-mihiel	non-scandalous
146.	volksstimme
censorships	noncontroversial
somwhat	meissener
cheltenham	readful
newport	tribune-owned
scatterer	dimples.
hard-heartedness	gum-chewers
ayenue	1,167,000
iscapal	news-and
=like	amphiryon
