politics	politics
232.	supplementsa
azmat	ethnic-confrontation
syncratic	doscope
tings	ollman
sinophiles	production-oriented
kit-.	hurtado
legitimizes	sales-oriented
bourgeois	issues-oriented
hotsy-totsy	roldos
proviconvention	reformminded
backscratching	visceral-ecstatic
time-and-one-half	kalei
fvarren	billno
|p502	stage-manages
espe-	pelletier
embroilment	meta
jowett	personalises
gious	trickeson
history.	fri=
raltnond	knavish
aristotle	perennials-sex
industrialization	bertell
saidl	dept.
anzerlean	picnic-table-size
