politics	politics
philsophical	rcality
parliamentary-led	louay.
inexhaus-188	toril
hot-house	literaturc
liberal-democrats	sexual/textual
degawa	glocal
nonroutine	technololgy
lesser-	saba.
masato	hydrography
evilism	abstention
economics-where	24:547-565
lengle	de-facto
nonselfish	centralism
land-grants	mineralogy
groups-on	tegan
sportscasting	re-studying
tible	race-class-gender
pan-movements	n.d
thatcher-style	gahenas
china-watchers	rorty
tolay	frenn
eagan-	elecfreedom
arendt	dragon-slayer
autonomy-have	power-sharing
