politics	politics
morons	religen
gence	turkey-trot
vincing	handels-
&mutinies;	machtpolitik
hearsts	prize-fightin
pennsy	aust
lvania	o-hungarian
crsies	beni-hilal
butlers	jugglings
coexists	govel-per
economics	mcduse
anti-chamberlain	tetch
ort	s'pos
timpter	secretary-treasure
patent-leathers	boxe
bankses	machievelli
ousekeepin	lothair
litt1e,13rown	harmsworth
significantooks	third-party
potitic.s.	germanys
fatuus	grizzly-bear
hutchinson.	bunny-hug
sesthetice	prognosticators
ventus	agrippines
