politics	politics
e-.61-0.0-0.491	232.
politiques	azmat
eco-.	syncratic
andeven	tings
fouradam	sinophiles
nomics	kit-.
half-fiction	legitimizes
africa-born	bourgeois
self-description	hotsy-totsy
54,282-a	proviconvention
ground-last	backscratching
army-turned	time-and-one-half
anglo-dutch	fvarren
life-affirmation.	|p502
fusionist	espe-
nal+	embroilment
d'etudes	jowett
over-corrected	gious
new-come	history.
whatp269you	raltnond
religion	aristotle
tician	industrialization
block-buster	saidl
economics	anzerlean
