politics	politics
non-gypsy	soldier-statesmen
gorgio	clientelism
state-managed	disenchantments
riverple	nuo
starkie	broad-casting
rogime	d'aff
peo-98	dewson
coniron	proliferate
thoroughhistorians	jugend-most
graft-infested	rimouski
tinue	upsy-downsy
|p175stoo|ping	ambitions.
afterwardsand	odegard
marck	helle
hero-philosopher	contractually
s.-owned-	shake-out
intraparty	graybackfarmer
anti-liquor	steinbuehl
majored	hatemaking
fumitaka	dilettantist
alumnae	powdermetallurgy
c'monwhy	lurope
jimtwelve	yeastier
peg-top	polities
