press	press
associated	associated
tribuno	thorp-princeton
seniee	farrand
lchleuso	$17.50.
hope-lincoln	kingsley-margaret
joergensen.	pic.tures
man-elizabeth	in-vented
mazur-viking	thirteen-story
hughes-columbia	tribune
states-edward	echicauro
eitor	half-plea
av.rm	book-agent
vec.	halfwarning
osborn-princeton	lichfield-edited
dibble-viking	kaiserreich
consequences-paul	n'ois.
hicago	university
ideas.	1411.
.11111b	dillichay
minippli	edition-oxford
roberts-viking	gleichgewichte
tzarina-princess	222the
double-cylinder	195smirtnevertheless
28.	lavishlyinvited
