press	press
clarendon	associated
buechner.	tribuno
lemeke	seniee
72;4370;toolong	lchleuso
university	hope-lincoln
14s.	joergensen.
rafter-room	man-elizabeth
72;4648;toolong	mazur-viking
boden	hughes-columbia
71;330;toolong	states-edward
walston	eitor
co	av.rm
cambridge	vec.
riverside	osborn-princeton
lemcke	dibble-viking
americsm	consequences-paul
seeked	hicago
assurer	ideas.
aimpaign	.11111b
net	minippli
berwick	roberts-viking
oxf	tzarina-princess
unstinted-	double-cylinder
woodthorpe	28.
