press	press
associated	associated
thorp-princeton	11111mmin11
farrand	win/moto
$17.50.	blindly.
kingsley-margaret	tassocloted
pic.tures	anuclated
in-vented	norgaard
thirteen-story	berding
tribune	addressograph
echicauro	andrue
half-plea	wtreihutol
book-agent	agent
halfwarning	servicei
lichfield-edited	white-spatted
kaiserreich	conference
n'ois.	noland
university	$6.50
1411.	aldus
dillichay	wirephoto
edition-oxford	theater-wise
gleichgewichte	delacorte
222the	dacre
195smirtnevertheless	university
lavishlyinvited	manutius
