press	press
associated	conference
conference	224.
pergamon	of'chicago
taves	abass
chian	rassoull
tribune	inter/101mm
conferences	prewatergate
raforrod	1-diiisto
d'autun	secretary
teixeira	unitad
sculpteur	stinehour
senice	itit.sec314
residiiag	days-gerald
serdati	conferences
kambiz	tirsday
wiftnrial	univ
cosmeticians	hogarth
vntir	fordbrezhnev
tioted	presiden-
yazdan-p4knah	briefings
trianon	colit'llied
soncino	judged-by
comm.	associated
acacio	open-admission
