press	press
associated	associated
11111mmin11	conference
win/moto	sum-1
blindly.	moned
tassocloted	chiesen
anuclated	sersivel
norgaard	conferehce
berding	rribune
addressograph	foust
andrue	hagerty
wtreihutol	vobis
agent	annuntio
servicei	post-standard
white-spatted	pse.s
conference	presid.ntial
noland	caffrey
$6.50	amacpc-itzs
aldus	rxa
wirephoto	polowetsky
theater-wise	ble-acting
delacorte	office.of
dacre	toggle
university	chislers
manutius	dou
