press	press
associated	associated
conference	conference
sum-1	pergamon
moned	taves
chiesen	chian
sersivel	tribune
conferehce	conferences
rribune	raforrod
foust	d'autun
hagerty	teixeira
vobis	sculpteur
annuntio	senice
post-standard	residiiag
pse.s	serdati
presid.ntial	kambiz
caffrey	wiftnrial
amacpc-itzs	cosmeticians
rxa	vntir
polowetsky	tioted
ble-acting	yazdan-p4knah
office.of	trianon
toggle	soncino
chislers	comm.
dou	acacio
