news	news
newspaper	dispatches
dispatch	information
tidings	sensational
message	newspaper
papers	newspapers
information	papers
sensational	reports
announcement	messages
dispatches	press
camboja	dispatch
arrival	paper
newspapers	daily
reporters	telegram
daily	message
telegram	happened
announcing	london
gossip	telegrams
reports	mail
journal	weekly
luis	rumors
concerning	correspondent
herald	story
coming	reporter
impending	letter
