news	news
newspaper	newspaper
press	press
newspapers	newspapers
daily	hearst
tribune	editorial
magazine	tribune
editor	dispatches
reporter	herald
story	daily
hearst	correspondent
gazette	radio
editors	reporter
editorials	dispatch
correspondent	columnist
radio	story
bulletin	editor
editorial	reported
reports	editorials
herald	coverage
headline	publisher
correspondents	headline
dispatch	editors
london	circulation
chronicle	weekly
