news	news
press	television
newspaper	newspaper
television	broadcast
radio	press
newspapers	media
herald	cbs
tv	abc
tribune	tv
reporters	network
daily	radio
broadcasts	coverage
reports	story
headlines	reporter
story	nbc
editorial	broadcasting
interview	headlines
coverage	interview
sunday	newspapers
magazine	reporting
reporter	editors
bulletin	ads
broadcast	broadcasts
commentator	magazine
media	correspondent
