news	news
newspaper	press
press	newspaper
newspapers	television
hearst	radio
editorial	newspapers
tribune	herald
dispatches	tv
herald	tribune
daily	reporters
correspondent	daily
radio	broadcasts
reporter	reports
dispatch	headlines
columnist	story
story	editorial
editor	interview
reported	coverage
editorials	sunday
coverage	magazine
publisher	reporter
headline	bulletin
editors	broadcast
circulation	commentator
weekly	media
