news	news
newspaper	press
newspapers	newspaper
press	newspapers
daily	daily
herald	tribune
editor	dispatches
papers	herald
tribune	editors
printed	correspondent
editorial	papers
columns	dispatch
journal	editor
weekly	correspondents
gazette	editorial
york	london
headlines	publications
editorials	journal
reports	monitor
magazine	reports
publisher	headlines
correspondent	times
publicity	weekly
article	york
print	publishers
