news	news
press	newspaper
newspaper	press
newspapers	newspapers
daily	daily
tribune	tribune
dispatches	magazine
herald	editor
editors	reporter
correspondent	story
papers	hearst
dispatch	gazette
editor	editors
correspondents	editorials
editorial	correspondent
london	radio
publications	bulletin
journal	editorial
monitor	reports
reports	herald
headlines	headline
times	correspondents
weekly	dispatch
york	london
publishers	chronicle
