news	news
dispatches	newspaper
information	newspapers
sensational	press
newspaper	daily
newspapers	herald
papers	editor
reports	papers
messages	tribune
press	printed
dispatch	editorial
paper	columns
daily	journal
telegram	weekly
message	gazette
happened	york
london	headlines
telegrams	editorials
mail	reports
weekly	magazine
rumors	publisher
correspondent	correspondent
story	publicity
reporter	article
letter	print
