politics	politics
political	political
history	ideology
partisan	issues
diplomacy	history
philosophy	conservative
ideology	economics
science	democratic
economics	philosophy
issues	religion
liberal	liberal
election	psychology
matters	affairs
sociology	ideological
cynicism	modern
voters	literature
democratic	party
scandal	electoral
chemistry	voters
religion	social
realities	geography
politicians	policy
american	culture
duplessis	debate
campaign	morality
