politics	politics
political	political
religion	affairs
affairs	philosophy
partisan	corrupt
history	politicians
politician	issues
morals	economics
corrupt	history
politicians	matters
literature	hague
economics	deal
everyday	considerations
corruption	morals
science	politician
graft	business
matters	career
diplomacy	diplomacy
business	liberal
petty	ethics
influence	theology
bosses	journalism
practical	party
greed	klan
philosophy	view
