politics	politics
political	political
ideology	religion
issues	ideology
history	liberal
conservative	democratic
economics	culture
democratic	nationalism
philosophy	history
religion	conservative
liberal	ideological
psychology	philosophy
affairs	corrupt
ideological	presidential
modern	peruvian
literature	partisan
party	debate
electoral	corruption
voters	era
social	rhetoric
geography	elections
policy	campaigns
culture	mainstream
debate	party
morality	dominated
