politics	politics
political	political
affairs	religion
economics	affairs
morals	partisan
politicians	history
business	politician
diplomacy	morals
religion	corrupt
ethics	politicians
science	literature
journalism	economics
philosophy	everyday
corrupt	corruption
intrigue	science
politician	graft
matters	matters
literature	diplomacy
psychology	business
morality	petty
discussion	influence
practical	bosses
corruption	practical
sociology	greed
deal	philosophy
