politics	politics
political	economics
affairs	affairs
philosophy	political
corrupt	religion
politicians	matters
issues	morals
economics	philosophy
history	matter
matters	history
hague	geography
deal	domestic
considerations	mathematics
morals	morality
politician	diplomacy
business	science
career	issues
diplomacy	sociology
liberal	ethics
ethics	partisan
theology	republicans
journalism	biology
party	literature
klan	liberal
view	corruption
