politics	politics
economics	political
political	affairs
history	economics
ethics	morals
partisan	politicians
literature	business
science	diplomacy
affairs	religion
politicians	ethics
finance	science
sociology	journalism
philosophy	philosophy
politician	corrupt
morals	intrigue
municipal	politician
modern	matters
religion	literature
corrupt	psychology
deals	morality
corruption	discussion
discussion	practical
election	corruption
field	sociology
business	deal
