politics	politics
political	political
ideology	history
bourgeois	partisan
issues	diplomacy
campaign	philosophy
marxist	ideology
history	science
industrialization	economics
tradition	issues
patronage	liberal
politicians	election
election	matters
party	sociology
politician	cynicism
society	voters
affairs	democratic
debates	scandal
philosophy	chemistry
geography	religion
era	realities
democracy	politicians
matter	american
democratic	duplessis
candidates	campaign
