press	press
newspapers	newspapers
published	newspaper
editor	news
publication	daily
publishing	tribune
newspaper	journal
journals	correspondent
periodical	published
printed	editorial
university	printed
news	herald
editorial	dispatches
dispatches	columns
editors	associated
london	print
printing	papers
daily	correspondents
journal	dispatch
oxford	gazette
cambridge	editor
publish	london
berlin	editorials
copyright	censorship
pamphlet	advertising
