press	press
reporters	news
news	washington
conference	reporters
newsmen	conference
media	briefing
newspaper	newspapers
ziegler	reporter
newspapers	official
interview	interview
reporter	media
powell	reports
speech	newspaper
statement	magazine
official	correspondent
briefing	week
television	leaked
nixon	leaks
broadcast	journalists
carter	conferences
correspondents	story
radio	print
print	embassy
journalists	article
televised	journal
