press	press
news	news
newspapers	newspaper
newspaper	newspapers
correspondent	reporters
correspondents	hagerty
washington	correspondent
dispatch	newsmen
tribune	correspondents
reporter	associated
london	editors
herald	official
associated	conference
official	radio
dispatches	washington
editor	daily
today	reported
daily	dispatches
radio	speech
embassy	weekly
reporters	secretary
reports	today
editors	dispatch
editorials	week
reported	broadcast
