press	press
newspapers	newspapers
newspaper	published
publishing	editor
london	publication
copyright	publishing
journal	newspaper
printed	journals
magazine	periodical
published	printed
papers	university
macmillan	news
correspondent	editorial
print	dispatches
journals	editors
reports	london
reporter	printing
publishers	daily
editor	journal
dispatches	oxford
bulletin	cambridge
publications	publish
dispatch	berlin
tribune	copyright
publication	pamphlet
