press	press
news	news
washington	reporters
reporters	editors
conference	tabloid
briefing	herald
newspapers	tribune
reporter	reporter
official	newspaper
interview	media
media	arden
reports	publisher
newspaper	magazine
magazine	editor
correspondent	journal
week	newspapers
leaked	carey
leaks	associated
journalists	columnist
conferences	washington
story	dan
print	york
embassy	correspondent
article	published
journal	ap
