press	press
news	reporters
reporters	news
newspaper	conference
conference	newsmen
washington	media
interview	newspaper
reporter	ziegler
speech	newspapers
television	interview
televised	reporter
newsmen	powell
salinger	speech
today	statement
official	official
newspapers	briefing
johnson	television
tribune	nixon
magazine	broadcast
photographers	carter
radio	correspondents
correspondents	radio
daily	print
media	journalists
commentator	televised
