press	press
news	news
newspapers	newspapers
newspaper	newspaper
daily	correspondent
correspondents	correspondents
correspondent	washington
dispatch	dispatch
dispatches	tribune
editors	reporter
tribune	london
editorial	herald
monitor	associated
london	official
herald	dispatches
washington	editor
official	today
editor	daily
berlin	radio
comment	embassy
publication	reporters
publications	reports
reports	editors
published	editorials
week	reported
